wwwwwwwwwwwwwwwwwwwwwwwwww
w-----c----A--w----------w
w-------------w----------w
w--e----------w----------w
w---c---------w----------w
w-------------w----------w
w-------------w----------w
w-------------w----------w
w-------------w----------w
w-------------w----------w
w-------------w----------w
w-------------w----------w
wwwwwwwwwwwwwwwwwwwwwwwwww