wwwwwwwwwwwwwwwwwwwwwwwwww
w-----c----A-------------w
wwwwww-------------------w
w------------wwwwwwww----w
w------------------------w
w------------------------w
w---wwwwwwwwwwwwww-------w
w------------------------w
w------------------------w
w------------e-----------w
w----wwwwwwwww-----------w
w------------------------w
wwwwwwwwwwwwwwwwwwwwwwwwww