wwwwwwwwwwwwwwwwwwwwwwwwww
w----x-----A-----w-------w
w----w------------w--x---w
wx----w----w-------w-----w
w-----w----w----x--w-----w
w-------x---w------------w
w----w---------w---x-----w
w----w-----------w-------w
w-x----------w---w-------w
w---w------x-----w-------w
w---w---------------x----w
wx--w------e----w--------w
wwwwwwwwwwwwwwwwwwwwwwwwww