wwwwwwwwwwwwwwwwwwwwwwwwww
w---------A--------------w
w------------------------w
w------------------------w
w------------------------w
w------------------------w
www-wwwwwwwwwwwwwwwwwwwwww
w------------------------w
w------------------------w
wwwwwwwwwwwwwwwwwww-w----w
w---------------www-w----w
w----------e-------------w
wwwwwwwwwwwwwwwwwwwwwwwwww